***************************************************
*.....******......*...*...........................*
*.....*...............*.....***..***..*****.......*
*.....*...........*...*******......*.............**
*.....***......****...*............********.......*
*.....*......*.....................*..............*
****..*......................******...****........*
*.........****.........*..........*.......***.....*
*....***....*****.......*...*.....*****...........*
*....*.............****.....*.....................*
***************************************************