***************************************************
*.................*...*...........................*
*.....*...........*...*.....*****.....*****.......*
*.....*...........*...*******...........*******..**
*.....******...****...*...........................*
*.................*...*...........................*
****..............*...*......******...****........*
*.........*****........*..........*.......***.....*
*....***..*****.........*.........*...............*
*....*....*****....**...........*.................*
***************************************************